{
    "width":25,
    "height":7,
    "grid":[
        "#########################",
        "#                       #",
        "#                     ###",
        "####      #####      ## #",
        "#       ####   ##       #",
        "##  ##                  #",
        "#########################"
    ]
}