{
    "width":20,
    "height":7,
    "grid":[
        "####################",
        "#                  #",
        "#                ###",
        "####      #     ## #",
        "#       ####       #",
        "##  ##             #",
        "####################"
    ]
}